  
{
    "blocks": [
      { "x": 0, "y": 475 },
      { "x": 50, "y": 475 },
      { "x": 100, "y": 475 },
      { "x": 150, "y": 475 },
      { "x": 200, "y": 475 },
      { "x": 250, "y": 475 },
      { "x": 300, "y": 475 },
      { "x": 350, "y": 475 },
      { "x": 400, "y": 475 },
      { "x": 450, "y": 475 },
      { "x": 500, "y": 475 },
      { "x": 550, "y": 475 },
      { "x": 600, "y": 475 },
      { "x": 650, "y": 475 },
      { "x": 700, "y": 475 },
      { "x": 750, "y": 475 }

  ]
  ,
      "clouds" :[
        { "x": 0, "y": 350 },
        { "x": 400, "y": 350 },     
        { "x": 800, "y": 350 }
      ]
}
