  
{
    "blocks": [
      { "x": 0, "y": 385 },
      { "x": 50, "y": 385 },
      { "x": 100, "y": 385 },
      { "x": 150, "y": 385 },
      { "x": 200, "y": 385 },
      { "x": 250, "y": 385 },
      { "x": 300, "y": 385 },
      { "x": 350, "y": 385 },
      { "x": 400, "y": 385 },
      { "x": 450, "y": 385 },
      { "x": 500, "y": 385 },
      { "x": 550, "y": 385 },
      { "x": 600, "y": 385 },
      { "x": 650, "y": 385 },
      { "x": 700, "y": 385 },
      { "x": 750, "y": 385 }
  ],
      "clouds" :[
        { "x": 0, "y": 350 },
        { "x": 400, "y": 350 },     
        { "x": 800, "y": 350 }
      ],
      "flags": [
        {"x": 400, "y": 400}
      ]
}
